NO ./textures/north.xpm
SO ./textures/south.xpm
WE ./textures/west.xpm

F 15,6,40
EA ./textures/east.xpm
C 25,0000000000000000000000000000000000000000000000000000000000000000019,73

111111111111111
111111000111111
111110000011111
1111000N0001111
111000010000111
110000111000011
100001111100001
110000111000011
111000010000111
111100000001111
111110000011111
111111000111111
111111111111111



